#########################
#S      #           #   #
####### # ######### ### #
#   #   #       # # #   #
# ### ### ##### # # # ###
# #   #     #   #   #   #
# # ### ##### ### ##### #
#   # #   #   # # #     #
# ### # ### ### # # ### #
# #     #   #   #   # # #
# # ##### ### # ##### # #
# #   #   #   #     #   #
# # ### ##### # ##### ###
# # #   #   # #     #   #
# ### ### # # ##### ### #
#   #     # #   #     # #
### # ##### # ### ##### #
# # # #     # #   #   # #
# # # # ####### ### # # #
#   # # #       #   #   #
# ### # # # ### # #######
# #   # # # #   #   #   #
# ##### # # ####### ### #
#       # #            E#
#########################
