#########################
#S        #             #
######### ########### # #
#       #         #   # #
# ### ########### # #####
#   #           # # #   #
### ######### # # # # # #
# #       #   # # #   # #
# # ####### ### # # ### #
#   #     # #   # # #   #
# ### ### # ##### ### # #
#   #   #   #     #   # #
### ### ##### ##### #####
#     # #     #   #     #
####### # ##### # # ### #
#       #     # # # #   #
# ########### # # ### # #
# #         #   #     # #
# # ##### ############# #
# #     # #       #   # #
# # ##### # # ### ### # #
# # #     # #   #     # #
# # # ##### ### ####### #
#   #         #        E#
#########################
