#########################
#S#   #             #   #
# # ### ######### # ### #
# #     #     #   #     #
# ### ##### # # ####### #
#   # #     # # #       #
### # # # ##### ### #####
# # #   # #   #   #     #
# # ####### # # # ##### #
# # #       # # #   #   #
# # # ####### ### # ### #
#   # #     #   # #   # #
# ### # # # ### # ### ###
# #   # # # #   #   #   #
# ### # # ### ######### #
#   # # # #   #       # #
### # # # # ### ##### # #
#   # # # # #   #   # # #
# ### ### # ### ### # # #
# #   #   #   #   #     #
# ### # ##### ### ##### #
#     # #   #   #     # #
####### # # ### ##### # #
#         #           #E#
#########################
