#########################
#S#       # #           #
# ##### # # # ######### #
#   #   #   # #   #   # #
### # ####### # # # # # #
# # #   #     # # # # # #
# # ### # ####### # # # #
# #   #   #       # # # #
# ### ### ### ##### # # #
#   #   #     #     # # #
# # ### ####### ##### # #
# # #   #       #   # # #
# # # ### ####### # # # #
# # #   # #   #   # # # #
# ##### # # # # ### # # #
#     # #   # # #   #   #
# # ### ### # ### # ### #
# #   #   # # #   #   # #
# ### ### # # # ##### # #
#   # #   # # #     # # #
##### # ##### # ### ### #
#     #   #   # # #     #
# ####### # ### # #######
#           #          E#
#########################
